***X******
*X*X*X****
*X*X***X*X
*X*X***X*X
*X*******X
*X*X*XXX*X
*****X****
**XXXX***X
*******X**
XX*XX*X***
