*X*******X
*X*XXXXX*X
*X***X***X
*XXXXX*XXX
*****X***X
XXXX*X*X*X
*****X*X*X
*XXXXXXX*X
**********
XXXXXXXXX*